R 0x00000000
R 0x00000020
R 0x00000040
R 0x00000060
R 0x00000080
R 0x000000A0
R 0x000000C0
R 0x000000E0
R 0x00000100
R 0x00000120
R 0x00000140
R 0x00000160
R 0x00000180
R 0x000001A0
R 0x000001C0
R 0x000001E0
R 0x00000200
R 0x00000220
R 0x00000240
R 0x00000260
R 0x00000280
R 0x000002A0
R 0x000002C0
R 0x000002E0
R 0x00000300
R 0x00000320
R 0x00000340
R 0x00000360
R 0x00000380
R 0x000003A0
R 0x000003C0
R 0x000003E0
R 0x00000400
R 0x00000420
R 0x00000440
R 0x00000460
R 0x00000480
R 0x000004A0
R 0x000004C0
R 0x000004E0
R 0x00000000
R 0x00000020
R 0x00000040
R 0x00000060
R 0x00000080
R 0x000000A0
R 0x000000C0
R 0x000000E0
R 0x00000100
R 0x00000120
R 0x00000140
R 0x00000160
R 0x00000180
R 0x000001A0
R 0x000001C0
R 0x000001E0
R 0x00000200
R 0x00000220
R 0x00000240
R 0x00000260
R 0x00000280
R 0x000002A0
R 0x000002C0
R 0x000002E0
R 0x00000300
R 0x00000320
R 0x00000340
R 0x00000360
R 0x00000380
R 0x000003A0
R 0x000003C0
R 0x000003E0
R 0x00000400
R 0x00000420
R 0x00000440
R 0x00000460
R 0x00000480
R 0x000004A0
R 0x000004C0
R 0x000004E0
R 0x00000000
R 0x00000020
R 0x00000040
R 0x00000060
R 0x00000080
R 0x000000A0
R 0x000000C0
R 0x000000E0
R 0x00000100
R 0x00000120
R 0x00000140
R 0x00000160
R 0x00000180
R 0x000001A0
R 0x000001C0
R 0x000001E0
R 0x00000200
R 0x00000220
R 0x00000240
R 0x00000260
R 0x00000280
R 0x000002A0
R 0x000002C0
R 0x000002E0
R 0x00000300
R 0x00000320
R 0x00000340
R 0x00000360
R 0x00000380
R 0x000003A0
R 0x000003C0
R 0x000003E0
R 0x00000400
R 0x00000420
R 0x00000440
R 0x00000460
R 0x00000480
R 0x000004A0
R 0x000004C0
R 0x000004E0
R 0x00000000
R 0x00000020
R 0x00000040
R 0x00000060
R 0x00000080
R 0x000000A0
R 0x000000C0
R 0x000000E0
R 0x00000100
R 0x00000120
R 0x00000140
R 0x00000160
R 0x00000180
R 0x000001A0
R 0x000001C0
R 0x000001E0
R 0x00000200
R 0x00000220
R 0x00000240
R 0x00000260
R 0x00000280
R 0x000002A0
R 0x000002C0
R 0x000002E0
R 0x00000300
R 0x00000320
R 0x00000340
R 0x00000360
R 0x00000380
R 0x000003A0
R 0x000003C0
R 0x000003E0
R 0x00000400
R 0x00000420
R 0x00000440
R 0x00000460
R 0x00000480
R 0x000004A0
R 0x000004C0
R 0x000004E0
R 0x00000000
R 0x00000020
R 0x00000040
R 0x00000060
R 0x00000080
R 0x000000A0
R 0x000000C0
R 0x000000E0
R 0x00000100
R 0x00000120
R 0x00000140
R 0x00000160
R 0x00000180
R 0x000001A0
R 0x000001C0
R 0x000001E0
R 0x00000200
R 0x00000220
R 0x00000240
R 0x00000260
R 0x00000280
R 0x000002A0
R 0x000002C0
R 0x000002E0
R 0x00000300
R 0x00000320
R 0x00000340
R 0x00000360
R 0x00000380
R 0x000003A0
R 0x000003C0
R 0x000003E0
R 0x00000400
R 0x00000420
R 0x00000440
R 0x00000460
R 0x00000480
R 0x000004A0
R 0x000004C0
R 0x000004E0
R 0x00000000
R 0x00000020
R 0x00000040
R 0x00000060
R 0x00000080
R 0x000000A0
R 0x000000C0
R 0x000000E0
R 0x00000100
R 0x00000120
R 0x00000140
R 0x00000160
R 0x00000180
R 0x000001A0
R 0x000001C0
R 0x000001E0
R 0x00000200
R 0x00000220
R 0x00000240
R 0x00000260
R 0x00000280
R 0x000002A0
R 0x000002C0
R 0x000002E0
R 0x00000300
R 0x00000320
R 0x00000340
R 0x00000360
R 0x00000380
R 0x000003A0
R 0x000003C0
R 0x000003E0
R 0x00000400
R 0x00000420
R 0x00000440
R 0x00000460
R 0x00000480
R 0x000004A0
R 0x000004C0
R 0x000004E0
R 0x00000000
R 0x00000020
R 0x00000040
R 0x00000060
R 0x00000080
R 0x000000A0
R 0x000000C0
R 0x000000E0
R 0x00000100
R 0x00000120
R 0x00000140
R 0x00000160
R 0x00000180
R 0x000001A0
R 0x000001C0
R 0x000001E0
R 0x00000200
R 0x00000220
R 0x00000240
R 0x00000260
R 0x00000280
R 0x000002A0
R 0x000002C0
R 0x000002E0
R 0x00000300
R 0x00000320
R 0x00000340
R 0x00000360
R 0x00000380
R 0x000003A0
R 0x000003C0
R 0x000003E0
R 0x00000400
R 0x00000420
R 0x00000440
R 0x00000460
R 0x00000480
R 0x000004A0
R 0x000004C0
R 0x000004E0
R 0x00000000
R 0x00000020
R 0x00000040
R 0x00000060
R 0x00000080
R 0x000000A0
R 0x000000C0
R 0x000000E0
R 0x00000100
R 0x00000120
R 0x00000140
R 0x00000160
R 0x00000180
R 0x000001A0
R 0x000001C0
R 0x000001E0
R 0x00000200
R 0x00000220
R 0x00000240
R 0x00000260
R 0x00000280
R 0x000002A0
R 0x000002C0
R 0x000002E0
R 0x00000300
R 0x00000320
R 0x00000340
R 0x00000360
R 0x00000380
R 0x000003A0
R 0x000003C0
R 0x000003E0
R 0x00000400
R 0x00000420
R 0x00000440
R 0x00000460
R 0x00000480
R 0x000004A0
R 0x000004C0
R 0x000004E0
