R 0x00001000
R 0x00001020
R 0x00001040
R 0x00001060
R 0x00001000
R 0x00001020
R 0x00001040
R 0x00001060
W 0x00001000
W 0x00001020
R 0x00001000
R 0x00001020
R 0x00001040
R 0x00001060
W 0x00001040
W 0x00001060
R 0x00001000
R 0x00001020
R 0x00001040
R 0x00001060
R 0x00001000
R 0x00001020
R 0x00001040
R 0x00001060
W 0x00001000
W 0x00001020
R 0x00001000
R 0x00001020
R 0x00001040
R 0x00001060
R 0x00001000
R 0x00001020
R 0x00001040
R 0x00001060
W 0x00001040
W 0x00001060
R 0x00001000
R 0x00001020
R 0x00001040
R 0x00001060
R 0x00001000
R 0x00001020
R 0x00001040
R 0x00001060
R 0x00001000
R 0x00001020
R 0x00001040
R 0x00001060
