R 0x00000000
W 0x00000020
R 0x00000040
W 0x00000060
R 0x00000000
W 0x00000020
R 0x00000040
W 0x00000060
R 0x00000000
W 0x00000020
R 0x00000040
W 0x00000060
R 0x00000500
W 0x00000520
R 0x00000540
W 0x00000560
R 0x00000500
W 0x00000520
R 0x00000540
W 0x00000560
R 0x00000500
W 0x00000520
R 0x00000540
W 0x00000560
R 0x00000000
W 0x00000020
R 0x00000040
W 0x00000060
R 0x00000000
W 0x00000020
R 0x00000040
W 0x00000060
R 0x00000500
W 0x00000520
R 0x00000540
W 0x00000560
R 0x00000500
W 0x00000520
R 0x00000540
W 0x00000560
R 0x00000000
W 0x00000020
R 0x00000040
W 0x00000060
R 0x00000500
W 0x00000520
R 0x00000540
W 0x00000560
