R 0x00000000
W 0x00000020
R 0x00000040
W 0x00000060
R 0x00000000
W 0x00000020
R 0x00000100
W 0x00000120
R 0x00000140
W 0x00000160
R 0x00000200
W 0x00000220
R 0x00000000
W 0x00000020
R 0x00000140
W 0x00000160
R 0x00000100
W 0x00000060
R 0x00000040
W 0x00000200
R 0x00000220
W 0x00000000
R 0x00000120
W 0x00000040
R 0x00000160
W 0x00000100
R 0x00000200
W 0x00000020
R 0x00000060
W 0x00000140
R 0x00000000
W 0x00000220
R 0x00000120
W 0x00000160
R 0x00000040
W 0x00000100
R 0x00000200
W 0x00000060
R 0x00000020
W 0x00000140
R 0x00000000
W 0x00000060
R 0x00000040
W 0x00000140
R 0x00000200
W 0x00000220
W 0x00000320
R 0x00000400
