R 0x00000000
R 0x00000100
R 0x00000200
R 0x00000300
R 0x00000400
R 0x00000000
R 0x00000100
R 0x00000200
R 0x00000300
R 0x00000400
W 0x00000000
W 0x00000100
W 0x00000200
W 0x00000300
W 0x00000400
R 0x00000000
R 0x00000100
R 0x00000200
R 0x00000300
R 0x00000400
W 0x00000000
W 0x00000100
W 0x00000200
W 0x00000300
W 0x00000400
R 0x00000000
R 0x00000100
R 0x00000200
R 0x00000300
R 0x00000400
R 0x00000000
R 0x00000100
R 0x00000200
R 0x00000300
R 0x00000400
W 0x00000000
W 0x00000100
W 0x00000200
W 0x00000300
W 0x00000400
R 0x00000000
R 0x00000100
R 0x00000200
R 0x00000300
R 0x00000400
R 0x00000000
R 0x00000100
R 0x00000200
R 0x00000300
R 0x00000400
